安徽	ah
北京	bj
福建	fj
甘肃	gs
广东	gd
广西	gx
贵州	gz
海南	hain
河北	heb
河南	hen
黑龙江	hlj
湖北	hub
湖南	hn
吉林	jl
江苏	js
江西	jx
辽宁	ln
内蒙古	nmg
宁夏	nx
青海	qh
山东	sd
山西	sx
陕西	shxi
上海	sh
四川	sc
天津	tj
西藏	xz
新疆	xj
云南	yn
浙江	zj
重庆	cq
其他	oth
